1111111111
1001111001
1000110001
1000010001
1000000001
1000100001
1000110001
1001111001
1011111101
1111111111
